Aaron Godby - ThePurduePete

Abhijith Ravishankar - MiNdFrEaK1994
Ace Zhang - Alethias
Alejandro Valle - TigreDelNorte
Alex Chan - Mesorouth
Alex Dutkevitch - MysticStormer
Alex Taylor - ATayy
Alex van Almelo - Spittfire
Andrew Batdorf - Weed Man
Andrew Cox - Pentragon
Andrew Fan - YuuTian
Andrew Huang- aBlazinAzn
Andrew Murrell - ImFromNASA
Andy Chen - MonoAlpaca
Andy Gustafson - iambox
Andy Tucker - DeadlySprinkles
Andy Zeng - Eternal Spring
Angus Lee - Mystem
Anirudh Reddy Madaka - Sightstone King
Anna Chen - LLEAFF
Anthony Kang - Tennisfrog
Anthony Malesevic - Flashamm
Arthur Huang - DraigonFTW
Arwin Mavaji - Cyanodon
Ashwin Mitra - Ashwindian
Austin Bauer - blackflame0729
Austin Deardorff - FeebleFest
Austin Jewell - ChongaChica
Azeem Sami - purdue
 
Ben Milks -iamherooftime
Billy Finger- DexterTheLogger
Billy Louie- Numbers533
Billy Modesitt - I Enjoy Turtles
Bobby Deaton - Bluedragon422
Brandon Cox - Bdonicles
Brandon Streby - streby
Brett Weiss - BMW 94
Brian Fultman - Dr Richtofen
Brice Berg - Hurpdurp Goriz
 
Caleb Elliott - Caleb531
Cameron Kachur - NashorBaron
Chase Brammer - Auditear
Chenghao Bi - cluelessbanana
Chingy - Cryonator
Chloe Director- Wilowysp
Chris Mason - Hawkballzzz
Chris Pratt - Tyroche
Chris Sandford - Sergeant Schultz
Cody Steinhiser - Avenjade
Collin Koury - TheCheddz
Conner Sartain - LegendaryVamp
Connor Doll - Abilion
Connor Rieke - Dravadrag
Connor Roycraft - PopeSquad
Corey Pitzo - thebeist
 
Daniel Seamans - voug
Dan Golant - ILOVELEMONS
Daniel Miller - Brahmancer II
Dan Weller - Scizor021
Darius Pang - Atrenzia
Darrel Cheul - Enixius
David Flores - Death Gemerald
Derek R - Memnokk Mojo
Derek Schrag - Etrem
Devin Ridge - Plaugedwrath
Diana Yang - Reiyalin
Dillon Gonderman- Best Crabgot NA
Doug Hess - Coltsbro
Drew Robinson - Vibbard
Dustin Krause - deltadaragon
Dustin Neff - DatDoost 
Eddy Satchwill - Ed3
Eric Hamilton - Fiddletricks
Eric Han - AugustBlade 
Eric Scott - OchoNueve
Erick Smith - Aantorad
Eric Huang-yellow ragequit
Erik Kupsis - Erktizz
Erik Rozolis - MisterMrErik
Ethan Graber - clericalgerbil
Ethan Whitaker - Fr0mNowhere
Eugene Tseng - Deathnoob
Evan Cortez - BattleSageh
Evan Howe - Santhresh
 
Gabe Sequeira - Oniliva
Gabriel Chen - DrownWithin
Garrett McMindes- Searingshadow
 
Hunter Martin - JockSupport
 
Ian Watterson - The Wattermann
Ian Lioe - Aceleo
Ian Geis - BOOM815
 
Jack Dill- IRSAuditor
Jacob Anderson- CallMeMurseCha
Jacob Beard- Zefrin
Jacob Bissinger - Archyy
Jacob Dunbar - Hobofreddy55
Jacob Sears - RelictoDeo
Jacob Swierc - Doomseidzarro
James Boylan - jimbodeeny
James Brand - Zulthann
James Li - PeanutBoyy
James Massengale - Silverhatred
Jared Vannucci - Shinigami no Ken
Jarron Burdine - Jarronomo
Jason TenBarge - peaSea
Jennifer - Gwenevre
Jeremy Lehman-Gorath
Jessica Louise - lovelymaiden
John Jaemin Kim- jfk1994
John Renner- Rennerj
John-Paul Schmitz- dragonx8
Jonathan Giron- Master Pimp Sage
Jonathan N. - hungry snacks
Jonathan Tucker - Thundamuggin
Joohyung Kim - Aoi Sona
Jordan Whitcomb - his existence
Josh Beals - Jobenesc
Josh Lathrop - secretpunch
Josh Hernandez - Hondo22
Joshua Meehan - Tedobobedo
Joshua Woodard - Joshoowah
Justin Legare - Zarcia
Justin Montgomery - MONTY721
Justin Steuer - Poondizzler
 
Kay Lloyd - SteelFangs
Klay Simmons - HousePeddler
Kyle Den Hartog - Astastaine
Kyle Fischer - Fischman12
Kyle Green- night lovin
Kyle Petrucci - CountChoculah
Kyle Patterson - Cannibal Armada
Kevin Lee - YUMIWING
Kunal Agrawal - Alkatraz2344
 
Lance Von Ah - Lanceinthepants
Lancer Lin - L4nc3R CN
Lawrence - HellzBandit
Logan Zehr - TehFredBurger
Lane Owen - HairyManNeoWolf
 
Malik Browne - Milkstarz
Marc Portis - Bossnigha
Marcus Wilkins - Wakka
Mark Yang - Homo Asian
Matt Horner - Catafrakt
Matt Miller - The Murderinator
Matt Moyer - Dingo Republic
Matthew Parsons - Krauxiliary
Matt Simpson - PhatPimpson
Melvin Bontrager - pyro89man
Michael Brinker - Shankomatic
Michael Hockerman - ryhr
Michael Jamerson - Porphyrous
Michael Mccann - CoolMike1
Michael Sprau - Sanio
Michael Stevens - Shinku443
Michael Van Bosch - Apmaster5
Michael Weir - ShadowSya
Michael Yang - Kaizer5777
Michael Young - Gingerblades
Mike Croly - kT Mike
Mikel Duncan - Malik Arrum
Mitch Holm - AerialToaster
Mohamed K Ballaith - TP Dming
Matt Paskoff - CoviePIMP
Madison Wurster - TheCerealMaster
 
Nate La Breche - A Wild Nate Dawg
Nelson Wang - voidscythe
Nick Larew - WowWrongButton
Nicholas Sardjono- Professor69
 
Paige Applegate - Winterlily27
Phil Budzenski - nophilter
Patrick Chi - Dragon1291
Patrick Gallagher - PGalls
Patrick Thuren - Saoss
Preston Porter - wetnjuicy77
Paul Mathis - GIRLSCOUT761
Paul Heldring - Dexodius
 
Ravi Vemula - Audible Silence5
Rebecca Vajda - Imabekahh
Renea Wilson : greenmonster17
Richard Li - Rich14
Ronnie Brown - Genryusai1549
Ronnie Tran - CheerUpEmo
Ruey Herng Lim- Rovensaal
Russell Alva Fields IV - rollmode
Ryan Filbern - Archduke Penguin
Ryan Gardner - SÃ³ulReaver
Ryan Green - Gr3enGiant
Ryan Lovell - Choasnight93
Ryan Marvel- CrispinG419
Ryan Maserang - Superbone1
Ryan Rumble - Man Ballz
Ryan Wolf - damightywolf
 
Samantha Knox - sunangelbaby
Sam Garvis - CPU Sivrag
Sam Rewolinski - Oexarity
Scott Neville - Zaraj
Seth Hovland - Spartha
Seunghun Lee(Kurt Lee) - Coconuttea
Shawn Carmichael - Segg Faultz
Simon Smith - Smith
Steven Chan- Doomlordeater
Steven Grile - skyrouter
 
Taylor Ruble- 3IG Truble
Terrence Jackson - Jaughny
 Thomas Thystrup - ThomasTET6
Tim Lang - Aerodactyl6
Tim Murphy - GandalfTheCyan
Tim Treahy-TheSpiritOfLife
TJ McCracken - Mythic Kage
 Tori Cooper - Twinkle Bloop
Travis Kent - vilex68
Treven Yeager - KinetiKz
Trevor Stone - Tastone
Tyler Koczenasz - Crazymoron67
Tyler Tharp - TheMandingo
Tyler King - Rezz
Tommy Burnson - I like asians
 
 
Van Masterson - Didact117
 
Wade Bassett - SubtleTroll
Wells Lin - Aurostyne
Wei Yuan - YueNwEi
Wesley Thai - Fishstand
Wilson Renea- Greenmonster17
Wang Tao -  ReApTiMe
 
YeChan Lim - lolateveryone
 
Zac Mosley - Dingo3227
Zachary Schmitz - Sliacen
Zach Urbanek - Zaccch
Zak Eckert - BOILERMAKKER
Zane Grote - Glenhall
