Unranked players: 

Alex Chan - Mesorouth
Andrew Batdorf - Weed Man
Austin Bauer - blackflame0729
Austin Jewell - ChongaChica
Brandon Cox - Bdonicles
Connor Roycraft - PopeSquad
Dan Golant - ILOVELEMONS
Daniel Miller - Brahmancer II
Derek R - Memnokk Mojo
Eric Scott - OchoNueve
Eugene Tseng - Deathnoob
Evan Howe - Santhresh
Hunter Martin - JockSupport
Ian Geis - BOOM815
Jacob Bissinger - Archyy
Jacob Sears - RelictoDeo
Jennifer - Gwenevre
Jonathan N. - hungry snacks
Jordan Whitcomb - his existence
Joshua Meehan - Tedobobedo
Klay Simmons - HousePeddler
Lance Von Ah - Lanceinthepants
Marc Portis - Bossnigha
Matt Moyer - Dingo Republic
Michael Brinker - Shankomatic
Michael Yang - Kaizer5777
Michael Young - Gingerblades
Mitch Holm - AerialToaster
Paul Mathis - GIRLSCOUT761
Rebecca Vajda - Imabekahh
Ryan Green - Gr3enGiant
Ryan Maserang - Superbone1
Terrence Jackson - Jaughny
 Tori Cooper - Twinkle Bloop
Trevor Stone - Tastone
Van Masterson - Didact117
Wade Bassett - SubtleTroll
Zac Mosley - Dingo3227
Zane Grote - Glenhall

Bronze players: 

Aaron Godby - ThePurduePete
Abhijith Ravishankar - MiNdFrEaK1994
Alejandro Valle - TigreDelNorte
Andy Tucker - DeadlySprinkles
Anirudh Reddy Madaka - Sightstone King
Anna Chen - LLEAFF
David Flores - Death Gemerald
Dustin Krause - deltadaragon
Jarron Burdine - Jarronomo
Josh Beals - Jobenesc
Josh Lathrop - secretpunch
Justin Steuer - Poondizzler
Kay Lloyd - SteelFangs
Kyle Den Hartog - Astastaine
Kyle Fischer - Fischman12
Matt Miller - The Murderinator
Matt Simpson - PhatPimpson
Melvin Bontrager - pyro89man
Michael Hockerman - ryhr
Mikel Duncan - Malik Arrum
Matt Paskoff - CoviePIMP
Paige Applegate - Winterlily27
Patrick Chi - Dragon1291
Tyler Koczenasz - Crazymoron67
Wei Yuan - YueNwEi

Silver players: 

Ace Zhang - Alethias
Alex van Almelo - Spittfire
Andrew Fan - YuuTian
Andrew Murrell - ImFromNASA
Andy Gustafson - iambox
Anthony Malesevic - Flashamm
Azeem Sami - purdue
Bobby Deaton - Bluedragon422
Brandon Streby - streby
Brian Fultman - Dr Richtofen
Brice Berg - Hurpdurp Goriz
Cameron Kachur - NashorBaron
Chase Brammer - Auditear
Chris Sandford - Sergeant Schultz
Cody Steinhiser - Avenjade
Collin Koury - TheCheddz
Conner Sartain - LegendaryVamp
Dan Weller - Scizor021
Darius Pang - Atrenzia
Diana Yang - Reiyalin
Eddy Satchwill - Ed3
Erick Smith - Aantorad
Ethan Graber - clericalgerbil
Gabe Sequeira - Oniliva
Jacob Dunbar - Hobofreddy55
James Boylan - jimbodeeny
Jared Vannucci - Shinigami no Ken
Jason TenBarge - peaSea
Jessica Louise - lovelymaiden
Kyle Patterson - Cannibal Armada
Lawrence - HellzBandit
Lane Owen - HairyManNeoWolf
Matt Horner - Catafrakt
Michael Sprau - Sanio
Phil Budzenski - nophilter
Patrick Gallagher - PGalls
Patrick Thuren - Saoss
Ravi Vemula - Audible Silence5
Ronnie Brown - Genryusai1549
Ryan Filbern - Archduke Penguin
Ryan Lovell - Choasnight93
Samantha Knox - sunangelbaby
Sam Garvis - CPU Sivrag
Scott Neville - Zaraj
Seth Hovland - Spartha
Simon Smith - Smith
Steven Grile - skyrouter
 Thomas Thystrup - ThomasTET6
TJ McCracken - Mythic Kage
YeChan Lim - lolateveryone
Zak Eckert - BOILERMAKKER

Gold players: 

Alex Dutkevitch - MysticStormer
Alex Taylor - ATayy
Andrew Cox - Pentragon
Anthony Kang - Tennisfrog
Ashwin Mitra - Ashwindian
Austin Deardorff - FeebleFest
Brett Weiss - BMW 94
Caleb Elliott - Caleb531
Chenghao Bi - cluelessbanana
Chris Mason - Hawkballzzz
Connor Doll - Abilion
Darrel Cheul - Enixius
Derek Schrag - Etrem
Dustin Neff - DatDoost 
Eric Hamilton - Fiddletricks
Erik Kupsis - Erktizz
Gabriel Chen - DrownWithin
Ian Lioe - Aceleo
Jacob Swierc - Doomseidzarro
James Brand - Zulthann
James Li - PeanutBoyy
James Massengale - Silverhatred
Jonathon Giron - Master Pimp Sage
Justin Legare - Zarcia
Kunal Agrawal - Alkatraz2344
Lancer Lin - L4nc3R CN
Logan Zehr - TehFredBurger
Matthew Parsons - Krauxiliary
Michael Jamerson - Porphyrous
Michael Van Bosch - Apmaster5
Michael Weir - ShadowSya
Nick Larew - WowWrongButton
Ronnie Tran - CheerUpEmo
Ryan Rumble - Man Ballz
Sam Rewolinski - Oexarity
Seunghun Lee(Kurt Lee) - Coconuttea
Shawn Carmichael - Segg Faultz
Travis Kent - vilex68
Wesley Thai - Fishstand
Wang Tao -  ReApTiMe

Platinum players: 

Andy Chen - MonoAlpaca
Angus Lee - Mystem
Arthur Huang - DraigonFTW
Billy Modesitt - I Enjoy Turtles
Connor Rieke - Dravadrag
Corey Pitzo - thebeist
Doug Hess - Coltsbro
Drew Robinson - Vibbard
Eric Han - AugustBlade 
Erik Rozolis - MisterMrErik
Jonathon Giron - PIayboy Bunny
Joohyung Kim - Aoi Sona
Joshua Woodard - Joshoowah
Kyle Petrucci - CountChoculah
Malik Browne - Milkstarz
Marcus Wilkins - Wakka
Mike Croly - kT Mike
Nate La Breche - A Wild Nate Dawg
Nelson Wang - voidscythe
Richard Li - Rich14
Ryan Wolf - damightywolf
Tim Murphy - GandalfTheCyan
Treven Yeager - KinetiKz
Tommy Burnson - I like asians
Wells Lin - Aurostyne
Zach Urbanek - Zaccch

Diamond players: 

Andy Zeng - Eternal Spring
Arwin Mavaji - Cyanodon
Chris Pratt - Tyroche
Daniel Seamans - voug
Ian Watterson - The Wattermann
Michael Stevens - Shinku443
Paul Heldring - Dexodius
Tim Lang - Aerodactyl6
Tyler King - Rezz
Zachary Schmitz - Sliacen

Challenger players: 


